{
  "width": 20,
  "height": 15,
  "tileSize": 32,
  "tiles": [
    [0, 0, 0, 0, 0, 0, 0, 0, 0, 0, 0, 0, 0, 0, 0, 0, 0, 0, 0, 0],
    [0, 0, 0, 1, 1, 1, 1, 1, 1, 1, 1, 1, 1, 1, 1, 1, 1, 0, 0, 0],
    [0, 0, 0, 1, 1, 1, 1, 1, 1, 7, 1, 1, 1, 3, 1, 1, 1, 0, 0, 0],
    [0, 0, 0, 2, 2, 2, 2, 2, 2, 2, 2, 2, 2, 2, 2, 2, 2, 0, 0, 0],
    [0, 5, 5, 1, 1, 1, 1, 1, 1, 1, 1, 1, 1, 1, 1, 1, 1, 5, 5, 0],
    [0, 5, 1, 1, 1, 1, 1, 1, 1, 1, 1, 1, 1, 1, 1, 1, 1, 1, 5, 0],
    [0, 1, 1, 1, 1, 1, 1, 1, 1, 1, 1, 1, 1, 1, 1, 1, 1, 1, 1, 0],
    [0, 1, 1, 1, 1, 1, 1, 1, 1, 1, 1, 1, 1, 1, 1, 1, 1, 1, 1, 0],
    [0, 1, 1, 1, 6, 6, 1, 1, 1, 1, 1, 1, 1, 1, 6, 6, 1, 1, 1, 0],
    [0, 1, 1, 1, 6, 6, 1, 1, 1, 1, 1, 1, 1, 1, 6, 6, 1, 1, 1, 0],
    [0, 1, 1, 1, 1, 1, 1, 1, 1, 1, 1, 1, 1, 1, 1, 1, 1, 1, 1, 0],
    [0, 1, 1, 1, 1, 1, 1, 1, 1, 1, 1, 1, 1, 1, 1, 1, 1, 1, 1, 0],
    [0, 5, 1, 1, 1, 1, 1, 1, 1, 1, 1, 1, 1, 1, 1, 1, 1, 1, 5, 0],
    [0, 5, 5, 1, 1, 1, 1, 1, 1, 1, 1, 1, 1, 1, 1, 1, 1, 5, 5, 0],
    [0, 0, 0, 0, 0, 0, 0, 0, 0, 4, 4, 0, 0, 0, 0, 0, 0, 0, 0, 0]
  ],
  "tileTypes": {
    "0": "wall",
    "1": "floor",
    "2": "counter",
    "3": "pc",
    "4": "door",
    "5": "plant",
    "6": "table",
    "7": "nurseJoy"
  },
  "walkable": [1, 4],
  "interactionZones": [
    {
      "id": "nurseJoy",
      "type": "npc",
      "facing": "up",
      "triggerRow": 4,
      "triggerColMin": 3,
      "triggerColMax": 16,
      "excludeCols": [13]
    },
    {
      "id": "pc",
      "type": "overlay",
      "facing": "up",
      "triggerRow": 4,
      "triggerCol": 13
    },
    {
      "id": "trainerCard",
      "type": "overlay",
      "facing": "down",
      "triggerRow": 7,
      "triggerColMin": 4,
      "triggerColMax": 5
    }
  ],
  "playerStart": {
    "col": 9,
    "row": 11
  },
  "exits": [
    { "row": 14, "colMin": 9, "colMax": 10, "to": "room2", "spawnCol": 14, "spawnRow": 4 }
  ]
}
