{
  "id": "room2",
  "name": "Outside",
  "width": 20,
  "height": 15,
  "tileSize": 32,
  "tiles": [
    [9, 9, 9, 9, 9, 9, 9, 9, 9, 9, 9, 9, 9, 9, 9, 9, 9, 9, 9, 9],
    [9,13,13,13, 9, 8, 8, 8, 8, 8, 8, 8, 9,13,13,13, 9, 8, 9, 9],
    [9,14,14,14, 9, 8, 8, 8, 8, 8, 8, 8, 9,14,14,14, 9, 8, 9, 9],
    [9,14,19,14, 9, 8, 8, 8, 8, 8, 8, 8, 9,14,19,14, 9, 8,15, 9],
    [9, 8, 8, 8, 8, 8,15, 8, 8, 8, 8, 8, 8, 8, 8, 8, 8, 8, 8, 9],
    [9,12,12,12,12,12,11,11,12,12,12,12,11,11,12,12,12,12,12, 9],
    [9,10,10,10,10,10,11,11,10,10,10,10,11,11,10,10,10,10,10, 9],
    [9,10,10,10,10,10,11,11,10,10,10,10,11,11,10,10,10,10,10, 9],
    [9,12,12,12,12,12,11,11,12,12,12,12,11,11,12,12,12,12,12, 9],
    [9, 8, 8, 8, 8, 8, 8, 8, 8, 8, 8, 8, 8, 8, 8, 8,15, 8, 8, 9],
    [9,13,13,13, 8, 8, 8, 8, 8, 8, 8, 8, 8, 8, 8, 8,16,16,16, 9],
    [17,14,14,14,8, 8, 8, 8, 8, 8, 8, 8, 8, 8, 8, 8,16,16,16, 9],
    [9,14,19,14, 8, 8, 8, 8,15,18,18,18, 8, 8, 8, 8,16,16,16, 9],
    [9, 8, 8, 8, 8, 8, 8, 8, 8,18,18,18, 8, 8, 8, 8, 8, 8, 8, 9],
    [9, 9, 9, 9, 9, 9, 9, 9, 9, 9, 9, 9, 9, 9, 9, 9, 9, 9, 9, 9]
  ],
  "tileTypes": {
    "4":  "exit",
    "8":  "grass",
    "9":  "tree",
    "10": "water",
    "11": "bridge",
    "12": "stone_bank",
    "13": "house_roof",
    "14": "house_wall",
    "15": "flower",
    "16": "corn",
    "17": "mailbox",
    "18": "path",
    "19": "house_door"
  },
  "walkable": [4, 8, 11, 18],
  "interactionZones": [
    {
      "id": "pcenterExit",
      "type": "exit",
      "facing": "up",
      "triggerRow": 4,
      "triggerCol": 14,
      "to": "room1",
      "spawnCol": 9,
      "spawnRow": 12
    }
  ],
  "playerStart": { "col": 9, "row": 2 },
  "exits": []
}
